w x w w w w w w w x
w w w w w w w w w w
w x w w w w w w w w
w p p w w w w x w w
w p p x x w w w w x
w p a d d d p p p w
w w w w w x w d p w
x w w w w w w d p x
w p x p d d p p p w
x p d p x x w w w w
x p d p x x x w x x
w w x p d d p p p w
x w w p p x p g p x
w p p p p x p p p w
x x x x x x x x x x
