w w w w w w w w w w
w w w w w w w w w w
w w w w w w w w w w
w p p w w w w w w w
w p p w w w w w w w
w p a d d d p p p w
w w w w w w w d p w
w w w w w w w d p w
w p d p d d p p p w
w p d p w w w w w w
w p d p w w w w w w
w w w p d d p p p w
w w w p p w p g p w
w p p p p w p p p w
w w w w w w w w w w
