w w w w w w w w w w
w w w w w w w w w w
w w w w w w w w w w
w p p d p p w l l w
w p d p d p w l l w
w s w w w p w w p w
w d l l w d p d p w
w d l l w d p d p w
w p w w w s w l l w
w p w p d s w l l w
w p w g w s w w w w
w p w w w p p p p w
w d d s s p p a p w
w d d w w p p p p w
w w w w w w w w w w
