w x w w w w w w w x
w w w w w w w w w w
w x x w w w x w w w
w p p d p p w x x w
w p d p d p w x x x
w s x w w p x x p w
w d x x x d p d p w
w d x x x d p d p x
w p x x x p w x x w
x p x p d s x x x w
x p w x x p w x x x
w p x w x p p p p w
x d d p p p p x p x
w d d w w p p p p w
x x x x x x x x x x
