w w w w w w w w w x
w w w w w w w w w w
w x x w w w w w w w
w k p p w w w b p w
w p a p g d B p p x
w s w w w x x h x x
w p p w d d x d p x
w p d p p p w d p x
w s w w w p p p x w
w p s p w h r p k w
x r w p x p p p w x
w p d d p r p p w w
x h w w x r w s w x
w p p d K p K d d w
x x x x x x x x x x
