w w w w w w w w w w
w w w w w w w w w w
w w w w w w w w w w
w k p p w w w b p w
w p a p g d B p p w
w s w w w w w h w w
w p p w d d w d p w
w p d p p p w d p w
w s w w w p p p w w
w p s p w h r p k w
w r w p w p p p w w
w p d d p r p p w w
w h w w w r w s w w
w p s d K p K d d w
w w w w w w w w w w
