w w w w w w w w w x
w w w w w w w w w w
w x x w w w w w w w
w p d a p s w d w w
x w x w w p s p s x
w w p K p s x x r x
w d p w p p p s d x
w w p x x x x x p x
w w B x l x l x p w
w d d p p w p p p w
x s x x r x p w d w
w s x p p w p r h w
x x d d p b p p g x
w w w w w x x w w x
x x x x x x x x x x
