w w w w w w w w w w
w w w w w w w w w w
w w w w w w w w w w
w p d a p s w d w w
w w w w w p s p s w
w w p K p s w w r w
w d p w p p p s d w
w w p w w w w w p w
w w B w l w l w p w
w d d p p w p p p w
w s w w r w p w d w
w s w p p w p r h w
w k d d p b p p g w
w w w w w w w w w w
w w w w w w w w w w