w w w w w w w w w w
w w w w w w w w w w
w w w w w w w w w w
w d d p s p d p k w
w d w s w w K w w w
w w w p p d p p p w
w d w p w r w w s w
w p s k B b p p d w
w p w p w w p w w w
w d w s w p p w s w
w p w p w d p s g w
w K w s w w s w w w
w p p d a p p d p w
w w w w w w w w w w
w w w w w w w w w w