w w w w w w w w w w
w w w w w w w w w w
w w w w w w w w w w
w p p d p p w d d w
w w B w g w w d d w
w p p p w p w B w w
w d p p d w p p p w
w p w B w p w h b w
w w p r b w d p p w
w p p p w d p p p w
w w K w p w w r w w
w b p p b p B p p w
w w p p r p w w k w
w w w w a w w w w w
w w w w w w w w w w
