w w w w w w w w w w
w w x w w w w w w w
w w w w w w w w x w
w g p w p s p d p w
x w K w p w p r p w
w p p w p x p p p w
w a p d p w d b p w
x s w w p x p r p x
x d w x p s p p p w
w p p w p w w w r w
w x p x d r h p p w
x p p w w x r w x w
x x p B p x p d p x
w w w w w w x w x x
x x x x x x x x x x
