w w w w w w w w w w
w w w w w w w w w w
w w w w w w w w w w
w g p w p s p d p w
w w K w p w p r p w
w p p w p w p p p w
w a p d p w d b p w
w s w w p w p r p w
w d w w p s p p p w
w p p w s w w w r w
w w s w d r h p p w
w p p w w w r w w w
w k p B p d p d p w
w w w w w w w w w w
w w w w w w w w w w
