w w w w w w w w w w
w w w w w w w w w w
w w w w w w w w w w
w l l l l l l l l w
w l l w l l w l l w
w l l l l l l l l w
w a p p w p p w d w
w p w p p p p r p w
w p w r w w r w p w
w p w p p d p w p w
w d p p p w p w p w
w p w w p p p d p w
w p w d p w w w w w
w p p p p h h h g w
w w w w w w w w w w
