w w w w w w w w w w
w w x w w w w x w w
w w w w w w w w w w
w l l l l l l l l w
x l l x l l x l l w
w l l l l l l l l w
w a p p w p p x d w
x p x p p p p r p x
x p w r w x r w p w
w p w p p d p w p w
w d p p p w p w p w
x p w w p p p d p w
x p w d p x x x w x
w p p p p h h h g x
x x x x x x x x x x
