w w w w w w w w w w
w w w w w w w w w w
w w w w w w w w w w
w p p d p s p w k w
w d w w w w p w B w
w p B k b B p b p w
w a w w d w w w d w
w p s p r p p p p w
w p s p r p w w w w
w p w w p w w w b w
w w w p p r p p p w
w d w s s w w p d w
w d K p p d w K w w
w w w w w w w p g w
w w w w w w w w w w
