w w w w w w w w w w
w w w w w w w w w w
w w w w w w w w w w
w p d p d p d p d w
w d w w w w w w B w
w p w p p d p p p w
w d w b w w p w s w
w p w p B g d r p w
w d w a w w p w d w
w p w p s p p w p w
w d w r w w b w d w
w p w p p s p w p w
w d r b p w d B p w
w w w w w w w w w w
w w w w w w w w w w