w w w w w w w w w w
w w w w w w w w w w
w w w w w w w w w w
w g w w k w p d p w
w d w p p w p w s w
w B b p p B p p p w
w p w w a w w p p w
w p s p d w w r d w
w p w p p p p p w w
w p w w r w w p p w
w d p d p w p p b w
w p w w w w s w w w
w p K p p p d p w w
w w w w w w w w w w
w w w w w w w w w w