w w w w w w w w w w
w w w w w w w w w w
w h p p r p p r p w
w w r w w p p p p w
w w p p p r p a p w
w p p r p h h w w w
w r p p r w r r w w
w w w w h w p r p w
w h h h r r h p p w
w g w w h r w w p w
w w w p p r w p p w
w p p p p h r r r w
w p h r r w p p p w
w r p p p w p r p w
w w w w w w w w w w
