w w w w w w w w w w
w w w w w w w w w w
w x x x x x x r x w
w w r w w p p p p w
x x p p p r p a p w
w p p r p h h x x w
w r p p r x r r x w
x w w w h w p r p x
x h h h r r h p p w
w g w x h r w x p w
w w w p p r w p p w
x p p p p h r r r w
x p h r r w p p p x
w r p p p w p r p x
x x x x x x x x x x
