w w w w w w w w w w
w w w w w w w w w w
w w w w w w w w w w
w p p p w p w p d w
w a p w w p K p g w
w p p s p p w p d w
w w s w K w w w w w
w p p w p p w d d w
w p d w p p K k d w
w w p w p p w d d w
w k p w d p w w w w
w p w w p p w p p w
w d s s p p K k d w
w p w w w k w p p w
w w w w w w w w w w
