x x x w w x w x x w
w w w w w w w w w w
w w w w w w w w w w
w p p p w p w p d x
x p a x x p K p g w
x p p p p p x p d w
x w p w K x w w x w
x p p x p p x d d w
w p d x p p K k d x
w w p x p p x d d x
w k p x d p w w w w
w p w w p p x p p x
w d s s p p K x d x
w p x x w k w p p w
x x x x x x x x x x
