w w w w w w w w w x
w w w w w w w w w w
w x w w w w w w w w
w p a p p p p p p w
w x w x w w r w x x
w p p d d p h p p w
w r w w w w w w w w
w h p p p r p d p x
w w w w w x d w x w
x p p p p p p p p w
x p r p p p p p p x
w x p p r w h x p w
x w x h d x g x p x
w w w w d x x x p w
x x x x x x x x x x
