w w w w w w w w w w
w w w w w w w w w w
w w w w w w w w w w
w p a p p p p p p w
w w w w w w r w w w
w p p d d p h p p w
w r w w w w w w w w
w h p p p r p d p w
w w w w w w d w w w
w p p p p p p p p w
w p r p p p p p p w
w w p p r w h w p w
w w w h d w g w p w
w w w w d w w w p w
w w w w w w w w w w
