w w w w w w w w w w
w w w w w w w w w w
w w w w w w w w w w
w g w w w w w d d w
w a s p p k w d d w
w s w w r w w w K w
w d w p p p w w h w
w d w p p p p p p w
w h w p p p p p p w
w p p p p p w p p w
w p p p p w w w p w
w l l l p w w x r w
w l l l p s s p p w
w w w w w d d w w w
w w w w w w w w w w
