w w w w w w w w w w
w w w w w w w w w w
w w w w w w w w w w
w p p p p a p p p w
w p r p d d p r k w
w h w p w w p w h w
w p p p p p p p p w
w p p p p p p p p w
w p p w w K w p p w
w p d w g d w p d w
w w K w w w w s w w
w h p d d d p p p w
w p w w w w w w s w
w s p d k d p p p w
w w w w w w w w w w
