w w w w w w w w w w
w w w w w w w w w w
w w w w w w w w w w
w w r p r p w w p w
w r a r p r p w p w
w p r w d w r w d w
w r p r p r w w r w
w w r p h p w k d w
w p d p w r w p r w
w r w w r p w p d w
w h r p p d p h w w
w p p w w K w w r w
w d p w p d p w p w
w p w w p g p w r w
w w w w w w w w w w
