w w w w w w w w w w
w w w w w w w w w w
w w d p d p d p w w
w w p w w w w d w w
x w d w p g w p w w
w w p d p d w p w w
w w w w w w w K w w
w w b p r a p d w w
w w w w w w w B w w
w w h r d s B p w w
w w k w s s w p w w
w w r w s s w s w w
w w h r p d b d w w
w w w w w w w w w w
w w w w w w w w w w
