w w w w w w w w w w
w w w w w w w w w w
w w w w w w w w w w
w p p p p a p p p w
w p r d d p p p p w
w b w w B w w w w w
w d p p r d d p w w
w w p p p p p p b w
w w B w w w w w w w
w p p w p p d p p w
w p p p p p p d p w
w p w p w p w B w w
w p r p w b w d p w
w d d d w d w p g w
w w w w w w w w w w