w w w w w w w w w x
w w w w w w w w w w
w x x w w x x w w w
w p p p p a p p p w
w p r d d p p p p x
w x w w x x x x x x
w d p p r d d p w w
w x p p p p p p b x
w x B x x x x x x w
w p p w p p d p p w
x p p p p p p d p x
w p w p x p w B x w
x p r p w b x d p x
w d d d x d x p g w
x x x x x x x x x x
