w w w w w w w w w x
w w w w w w w w w w
w x x w w w w w w w
w p p x p p x p p w
w d x w p p w x d x
w d d w g p w d d x
w p d x w a x d p x
w x p w p p w p x x
w d h p s s p h d w
w x p x r x x p x w
x p p p p p p p p x
w p r p p p p r p w
x p w p r r p w p x
w p p p p p p p p w
x x x x x x x x x x
