w w w w w w w w w w
w w w w w w w w w w
w w w w w w w w w w
w p p s p p s p p w
w d w w p p w w d w
w d d w g p w d d w
w p d w w a w d p w
w w p w p p w p w w
w d h p s s p h d w
w w s w r r w s w w
w p p p p p p p p w
w p r p p p p r p w
w p w p r r p w p w
w p p p p p p p p w
w w w w w w w w w w
