w w w w w w w w w w
w w w w w w w w w w
w w w w w w w w w w
w p p w w w w w w w
w p p w w w w w w w
w p p p p p p p p w
w w w w w w w p p w
w w w w w w w p p w
w p p p p p p p p w
w p p p w w w w w w
w p p p w w w w w w
w w w p p p p p p w
w w w p p w p a p w
w p p p p w p p p w
w w w w w w w w w w
