w w w w w w w w w w
w w x w w w w w w w
w w w w w w w w x w
w d d p s p d p x w
x d x s w w K x x w
x w w p p x p p p w
w d w p w r x x s w
w p s x B b p p d w
w p x p x x p w w w
w d w s x p p w s w
w p x p w d p p g w
x K w s w x p w x x
x p p d a p p d p x
w w w w w w x w x x
x x x x x x x x x x
