w w w w w w w w w w
w w x w w w w w w w
w w w w w w w w x w
w p p d p p w d d w
w w B w g w x d d w
w p p p w p w B x w
w d p p d x p p p w
x p x B w p x h b x
w w p r b w d p p w
w p p p x d p p p w
w w K w p w w r w w
x b p p b p B p p w
x w p p r p w x x x
w w w w a w x w x x
x x x x x x x x x x
