w w w w w w w w w w
w w x w w w w x w w
w w w w w w x w w w
w p p d p s p w x w
x d w w x w p x B w
w p B x b B p b p w
w a w x d x x w d w
x p s p r p p p p x
x p s p r p w w x w
w p w w p w w w b w
w w w p p r p p p w
x d x s s w x p d w
x d K p p d x K w x
w w w w w w w p g x
x x x x x x x x x x
