w w w w w w w w w w
w w x w w w w x w w
w w w w w w w w w w
w p d p d p d p d w
x d x w w w w w B w
w p x p p d p p p w
w d w b w x p x s w
x p x p B g d r p x
x d x a x w p w d w
w p x p s p p w p w
w d w r w w b x x w
x p w p p p p w p w
x d r b p w d B p x
w w w w w w w x x x
x x x x x x x x x x
