w w w w w w w w w w
w w x w w w w x w w
w w w w w w w w w w
w g x w x w p d p w
x d w p p x p x s w
w B b p p B p p p w
w p w w a x x p p w
x p s p d x w r d x
w p x p p p p p w w
w p x w r w w p p w
w d p d p x p p b w
x p x w w w s w w x
x p K p p p d p w w
w w w w w w w x x w
x x x x x x x x x x
