w x w w w w w w w x
w w w w w w w w w w
w x x w w w w w w w
w p p p w p w p d w
w a p x x p K p g x
w p p s p p x p d w
w w p w K w w x w w
w p p x p p x x d x
w p d x p p K x d w
x w p x p p x d d w
x k p x d p w x x x
w p w w p p x p p w
x d p p p p K x d x
w p w w w x x p p w
x x x x x x x x x x
