w w w w w w w w w x
w w w w w w w w w w
w w w w w w w w x w
w x x x x x w d d w
w a s p p x x d d x
w s w x r w x x x w
w d w p p p x x h w
w d x p p p p p p x
w h w p p p p p p w
x p p p p p x p p w
x p p p p x w w p x
w x x x p w w x r w
x x x x p s p p p x
w w w w w d d w x w
x x x x x x x x x x
