w w w w w w w w w x
w w w w w w w w w w
w w x w w w w w w w
w p p p p a p p p w
w p r p d d p x k x
w h w p w w p w h w
w p p p p p p p p w
w p p p p p p p p x
w p p w x K w p p w
w p d x g d x p d w
x w K x w x x s x x
w h p d d d p p p w
x p w w w w w w s x
w p p d x d p p p w
x x x x x x x x x x
