w w w w w w w w w x
w w w w w w w w w w
w w x w w w w w x w
w x x p x p w w p w
w x a r p r p w p x
w p r w d x r x d w
w r p r p r x x r w
w x r p h p x x d x
w p d p w r w p r w
w r w x r p w p d w
x h r p p d p h w x
w p p x w x w x r w
x d p w p d p x p x
w p w w p x p w x w
x x x x x x x x x x
