w w w w w w w w w x
w w w w w w w w w w
w w w w w w w w w w
w x p w w w x d w x
x w d x p g x p x x
w w p d p x w p x x
w w w w w w w K w w
w x b p r a p d x x
w x w w w x w B w w
w w h r d s B p w w
w w k x p s x p w w
w x r w p s w s x w
x x h r p d b d w x
w w w x w x w x x w
x x x x x x x x x x
